AAACCTGCAGTGACAG	tumor
AAACCTGGTCGAGATG	stromal
AAACCTGTCACCGGGT	stromal
AAACGGGGTGCACTTA	tumor
AAACGGGTCACGGTTA	tumor
AAAGATGAGCAGACTG	tumor
AAAGATGAGCAGCCTC	tumor
AAAGATGAGGTAAACT	tumor
AAAGATGCATGTCGAT	tumor
AAAGATGGTGCAGGTA	tumor
AAAGATGTCGTACCGG	tumor
AAAGCAAAGCGCTCCA	stromal
AAAGCAATCTATCCCG	tumor
AAAGCAATCTGGTTCC	tumor
AAAGTAGAGACCACGA	stromal
AAAGTAGCACCACCAG	tumor
AAAGTAGTCAGAGCTT	tumor
AAAGTAGTCAGGCAAG	tumor
AAAGTAGTCATACGGT	tumor
AAATGCCCAGACAAGC	stromal
AAATGCCCATGTAAGA	tumor
AAATGCCTCAATACCG	tumor
AAATGCCTCAGGTTCA	tumor
AAATGCCTCCTCAATT	stromal
AACCATGAGGAGTTGC	stromal
AACCGCGAGCTAGTCT	stromal
AACCGCGAGGAGTTTA	tumor
AACCGCGCAGGTTTCA	stromal
AACCGCGGTACAGCAG	tumor
AACCGCGTCGATCCCT	tumor
AACGTTGCAAGGACTG	tumor
AACTCAGAGCCCTAAT	stromal
AACTCAGTCGTTACGA	tumor
AACTCCCAGCTCCTCT	stromal
AACTCCCCACCAACCG	stromal
AACTCCCCACTGTCGG	tumor
AACTCCCGTGTGGTTT	tumor
AACTCTTAGAACTGTA	tumor
AACTCTTCACGTTGGC	tumor
AACTGGTAGACGCACA	stromal
AACTGGTAGGTGCTAG	tumor
AACTGGTCAGACACTT	tumor
AACTGGTCAGATCTGT	tumor
AACTTTCCAATCTACG	tumor
AACTTTCCACCGAAAG	tumor
AACTTTCGTTGACGTT	tumor
AACTTTCTCTATCCCG	tumor
AAGACCTAGCGCCTTG	tumor
AAGACCTTCATACGGT	tumor
AAGCCGCGTCCGTCAG	tumor
AAGCCGCTCATCGGAT	tumor
AAGGAGCAGTAGGCCA	tumor
AAGGAGCCATGTCGAT	stromal
AAGGAGCGTGTAATGA	tumor
AAGGAGCTCAGATAAG	stromal
AAGGAGCTCTCATTCA	tumor
AAGGCAGAGAACTCGG	tumor
AAGGCAGGTGCCTGGT	tumor
AAGGCAGGTTGCCTCT	tumor
AAGGCAGGTTGTCGCG	tumor
AAGGCAGTCGGCTTGG	tumor
AAGGTTCAGATGGGTC	stromal
AAGGTTCAGTCACGCC	stromal
AAGGTTCCAGTTTACG	tumor
AAGGTTCGTTAAAGTG	stromal
AAGTCTGCATGGATGG	tumor
AAGTCTGGTAGCGCTC	tumor
AAGTCTGGTGGTCCGT	tumor
AAGTCTGTCGCGCCAA	tumor
AATCCAGTCACCGGGT	stromal
AATCCAGTCAGCATGT	tumor
AATCGGTAGTGGTCCC	stromal
AATCGGTCACATGGGA	tumor
AATCGGTCACTCAGGC	tumor
AATCGGTCATCACCCT	tumor
AATCGGTGTGCCTGTG	stromal
AATCGGTTCATGTAGC	tumor
ACACCAAAGCCAGTAG	tumor
ACACCAAAGGCTCATT	stromal
ACACCAACAGCCAGAA	tumor
ACACCAACAGTCGATT	tumor
ACACCAATCTCAACTT	stromal
ACACCCTCACGAAATA	tumor
ACACCCTTCAAACAAG	tumor
ACACCGGAGGCAATTA	tumor
ACACCGGCAGACAAAT	tumor
ACACCGGGTTTGACTG	stromal
ACACTGATCAGCTCTC	tumor
ACACTGATCAGTTAGC	tumor
ACAGCCGAGCTAGTGG	stromal
ACAGCCGGTGTAAGTA	tumor
ACAGCCGGTTGACGTT	tumor
ACAGCCGTCCGCAAGC	stromal
ACAGCTACATGCCTAA	tumor
ACAGCTATCTTTCCTC	stromal
ACATACGCAACTTGAC	stromal
ACATCAGAGTGCGTGA	tumor
ACATCAGCACTCTGTC	tumor
ACATCAGTCAACACGT	stromal
ACATCAGTCATAACCG	stromal
ACATCAGTCGGCTTGG	stromal
ACATGGTTCAATAAGG	tumor
ACCAGTAAGGGAACGG	tumor
ACCAGTAAGTCGATAA	tumor
ACCAGTATCGTTACAG	tumor
ACCCACTAGCGCTTAT	tumor
ACCCACTCAAGCTGTT	tumor
ACCGTAAGTCCGCTGA	stromal
ACCGTAATCACTTATC	stromal
ACCGTAATCGTCCGTT	tumor
ACCTTTAGTCAGTGGA	tumor
ACGAGCCTCACCATAG	tumor
ACGAGGACAATCTGCA	tumor
ACGAGGAGTCATCGGC	stromal
ACGAGGAGTGATAAGT	tumor
ACGATACAGGCTCTTA	tumor
ACGATACCAGGTCCAC	tumor
ACGATGTAGTGAAGTT	stromal
ACGATGTCAATGGAAT	tumor
ACGATGTCAGTGACAG	tumor
ACGATGTTCCGTTGTC	tumor
ACGCAGCGTAGTACCT	tumor
ACGCAGCGTCGAACAG	tumor
ACGCAGCGTGCTCTTC	tumor
ACGCCAGCAGTAAGCG	stromal
ACGCCAGGTCCGAACC	tumor
ACGCCAGGTTTCGCTC	tumor
ACGCCAGTCATAGCAC	stromal
ACGCCAGTCCAAACTG	stromal
ACGCCAGTCCTTTCTC	tumor
ACGCCGACAACACGCC	tumor
ACGCCGAGTTAAGTAG	tumor
ACGCCGATCGTAGGTT	tumor
ACGCCGATCTCCCTGA	tumor
ACGGAGATCAACACTG	stromal
ACGGCCAAGGGTTCCC	tumor
ACGGCCACAAGTAATG	tumor
ACGGGCTAGACTGTAA	tumor
ACGGGCTCAAGTTCTG	tumor
ACGGGCTCACAGGTTT	tumor
ACGGGTCAGGAGCGAG	tumor
ACGGGTCAGGGCTTGA	tumor
ACGGGTCCATTTCACT	tumor
ACGGGTCGTATCTGCA	tumor
ACGGGTCGTGACAAAT	stromal
ACGTCAAAGAGCTGGT	stromal
ACGTCAAAGCTTATCG	tumor
ACGTCAAAGTCTCAAC	tumor
ACGTCAAGTAAGTGGC	tumor
ACTGAACGTAGGCTGA	tumor
ACTGAACTCATCGGAT	tumor
ACTGATGCACCCTATC	tumor
ACTGATGCACGAGGTA	stromal
ACTGCTCAGAAGAAGC	stromal
ACTGCTCAGACTGGGT	tumor
ACTGCTCCAACCGCCA	tumor
ACTGCTCGTACCGAGA	tumor
ACTGCTCGTTACAGAA	tumor
ACTGCTCTCTGAGGGA	tumor
ACTGTCCAGCTGTCTA	tumor
ACTGTCCCACGGTTTA	tumor
ACTGTCCGTACCCAAT	tumor
ACTGTCCTCTTGTATC	tumor
ACTTACTGTTCAGGCC	tumor
ACTTGTTAGTCCGTAT	tumor
ACTTGTTCATTAACCG	tumor
ACTTGTTGTGATGATA	stromal
ACTTGTTTCGGACAAG	stromal
ACTTTCAAGGCTCTTA	tumor
ACTTTCATCAACACAC	stromal
ACTTTCATCTGTCTCG	tumor
AGAATAGCAGCATGAG	stromal
AGAATAGCATTACGAC	tumor
AGAATAGGTAGCGTAG	stromal
AGAATAGGTCGAGATG	tumor
AGAATAGGTTCGGCAC	tumor
AGAATAGTCGCAAGCC	tumor
AGACGTTCAACTGCGC	stromal
AGACGTTGTTTAGGAA	tumor
AGACGTTTCACAAACC	stromal
AGACGTTTCTGCGTAA	tumor
AGAGCGAAGAAGAAGC	tumor
AGAGCGACAGTCCTTC	stromal
AGAGCGATCGTTTATC	tumor
AGAGCTTAGACGCTTT	tumor
AGAGCTTCAAACGCGA	tumor
AGAGCTTCAACCGCCA	stromal
AGAGTGGAGATACACA	stromal
AGAGTGGCACTCGACG	tumor
AGATCTGAGCTGTCTA	tumor
AGATCTGGTTTGGGCC	tumor
AGATTGCGTAACGTTC	stromal
AGATTGCGTGCCTTGG	tumor
AGATTGCTCATCATTC	stromal
AGCAGCCCATGACATC	tumor
AGCAGCCTCAGATAAG	tumor
AGCATACAGATCTGAA	tumor
AGCATACCACCACGTG	stromal
AGCATACCAGCTGTTA	stromal
AGCCTAAAGCAGCGTA	stromal
AGCCTAATCCCTTGCA	stromal
AGCGGTCCATTTGCCC	tumor
AGCGGTCGTTGGACCC	tumor
AGCGTATGTGGCTCCA	tumor
AGCGTATTCGGAAATA	stromal
AGCGTCGAGAGATGAG	tumor
AGCGTCGAGGACAGCT	tumor
AGCTCCTCACGGCCAT	tumor
AGCTCCTCAGGGTATG	tumor
AGCTCTCAGATGTTAG	tumor
AGCTCTCGTTGAACTC	tumor
AGCTTGACAGTATGCT	stromal
AGCTTGAGTCGGCACT	stromal
AGGCCACAGCAGATCG	tumor
AGGCCACAGGTGATAT	tumor
AGGCCACGTAATCACC	stromal
AGGCCACTCAACTCTT	tumor
AGGCCGTAGAAGGTTT	tumor
AGGCCGTCAAGCCTAT	tumor
AGGCCGTCACACATGT	tumor
AGGCCGTCAGCTCCGA	stromal
AGGCCGTGTCAGATAA	tumor
AGGCCGTGTGCACGAA	tumor
AGGCCGTTCCCATTAT	tumor
AGGGAGTAGCGTAATA	tumor
AGGGAGTAGGCTACGA	stromal
AGGGAGTGTAGAGCTG	tumor
AGGGATGAGACTAGGC	tumor
AGGGATGGTAGCGCAA	tumor
AGGGATGTCAACGGCC	tumor
AGGGATGTCAGGCCCA	tumor
AGGGATGTCTGCTGCT	tumor
AGGGTGAAGATTACCC	tumor
AGGGTGACAGATGGGT	tumor
AGGGTGAGTCAATGTC	tumor
AGGGTGAGTTGAACTC	tumor
AGGGTGATCATGCAAC	tumor
AGGTCATCAGCCTTTC	tumor
AGGTCATTCAACGAAA	tumor
AGGTCATTCAGTTAGC	tumor
AGGTCCGGTTCCGGCA	tumor
AGGTCCGTCTTATCTG	stromal
AGGTCCGTCTTTACAC	tumor
AGTAGTCAGAGTACAT	tumor
AGTAGTCAGAGTCTGG	tumor
AGTAGTCAGGTGCAAC	tumor
AGTAGTCGTGCACGAA	stromal
AGTAGTCGTTACCGAT	tumor
AGTAGTCTCATGCATG	tumor
AGTCTTTAGATCCTGT	tumor
AGTCTTTAGCTGAACG	tumor
AGTCTTTAGGTCGGAT	tumor
AGTCTTTCACAGCGTC	tumor
AGTCTTTGTTGCGTTA	stromal
AGTGAGGCACAGTCGC	stromal
AGTGAGGCACGAAATA	tumor
AGTGAGGGTATCGCAT	tumor
AGTGAGGGTGCTCTTC	tumor
AGTGAGGTCAGCAACT	tumor
AGTGAGGTCATAAAGG	tumor
AGTGAGGTCATCATTC	stromal
AGTGAGGTCCTTGCCA	tumor
AGTGAGGTCTAACTGG	tumor
AGTGGGAAGACTAGGC	tumor
AGTGGGAAGCCACGCT	tumor
AGTGGGAAGGAGTACC	tumor
AGTGGGACAATTCCTT	tumor
AGTGGGACACTGTCGG	stromal
AGTGGGATCTGGTGTA	stromal
AGTGTCAAGAGCTATA	tumor
AGTGTCACACGGTTTA	tumor
AGTGTCACAGATCCAT	tumor
AGTGTCAGTGTGAATA	tumor
AGTGTCAGTTGATTGC	tumor
AGTTGGTAGCGCCTTG	tumor
AGTTGGTAGTACGCGA	tumor
ATAACGCCAACAACCT	stromal
ATAACGCCACAGTCGC	stromal
ATAACGCGTGAGGGAG	tumor
ATAAGAGGTAGAGTGC	tumor
ATAAGAGGTTGTCTTT	tumor
ATAAGAGTCCTTTCGG	tumor
ATAGACCCACACATGT	tumor
ATAGACCCAGGACCCT	tumor
ATAGACCTCGATAGAA	tumor
ATAGACCTCGTAGGTT	tumor
ATCACGAGTAGATTAG	tumor
ATCACGATCGCAAACT	tumor
ATCACGATCTATGTGG	tumor
ATCATCTCACCGCTAG	stromal
ATCATCTCAGGTCTCG	tumor
ATCATCTTCAAGAAGT	tumor
ATCATGGAGAATGTGT	tumor
ATCATGGCAACCGCCA	tumor
ATCATGGCAACGATGG	stromal
ATCATGGCACTGTTAG	tumor
ATCATGGGTTTAGCTG	tumor
ATCATGGTCGTTTATC	tumor
ATCCACCTCAAAGACA	tumor
ATCCACCTCTGTACGA	stromal
ATCCGAACATTCGACA	tumor
ATCGAGTGTCGGGTCT	tumor
ATCTACTAGTGGTAAT	tumor
ATCTACTCACGAGGTA	tumor
ATCTACTTCGCCTGTT	stromal
ATCTGCCCACGCCAGT	tumor
ATCTGCCCATCGGGTC	stromal
ATCTGCCGTAGCGTAG	tumor
ATCTGCCTCCACGAAT	tumor
ATCTGCCTCCTTTACA	tumor
ATGAGGGCAATCAGAA	tumor
ATGCGATAGACCCACC	tumor
ATGCGATCATCCTAGA	stromal
ATGCGATGTACGAAAT	tumor
ATGGGAGAGAAACGAG	tumor
ATGGGAGAGAACTGTA	stromal
ATGTGTGCATGTCTCC	tumor
ATGTGTGGTATGAATG	tumor
ATTACTCCATACTACG	tumor
ATTATCCGTCATGCAT	tumor
ATTATCCGTGACTACT	stromal
ATTATCCGTGCACCAC	stromal
ATTATCCGTTCAGACT	tumor
ATTCTACAGACATAAC	tumor
ATTCTACAGAGCCCAA	tumor
ATTCTACCACATGGGA	tumor
ATTCTACGTCCAACTA	tumor
ATTCTACGTCGCTTTC	tumor
ATTGGTGCAGCTGCTG	tumor
ATTGGTGGTCTCCACT	tumor
ATTGGTGTCAACTCTT	tumor
ATTTCTGAGCGGATCA	tumor
ATTTCTGAGGGATCTG	stromal
CAACCAAAGGTTCCTA	stromal
CAACCAATCAAACAAG	stromal
CAACCAATCAGCAACT	stromal
CAACCTCGTAACGTTC	stromal
CAACCTCGTCAGCTAT	tumor
CAACCTCTCATCGCTC	tumor
CAACTAGAGGCATGTG	tumor
CAACTAGAGTAACCCT	tumor
CAACTAGTCAGCATGT	tumor
CAACTAGTCTCCCTGA	tumor
CAAGAAAGTGAAGGCT	stromal
CAAGATCAGAAACCGC	tumor
CAAGATCAGTGAAGTT	tumor
CAAGATCCATATGGTC	stromal
CAAGATCCATCATCCC	stromal
CAAGATCGTCAGAAGC	stromal
CAAGATCTCGGATGTT	tumor
CAAGGCCAGAATGTGT	tumor
CAAGGCCAGTGTCCCG	tumor
CAAGGCCAGTTGCAGG	tumor
CAAGGCCCATCACGTA	tumor
CAAGGCCGTAAACACA	stromal
CAAGGCCGTACCGGCT	tumor
CAAGGCCTCACCGGGT	tumor
CAAGGCCTCCAACCAA	tumor
CAAGGCCTCCACGTTC	tumor
CAAGTTGAGACTGGGT	tumor
CAAGTTGCATGTTGAC	tumor
CACAAACAGAGCCCAA	tumor
CACAAACCAGTTCCCT	tumor
CACAAACCATCCGGGT	tumor
CACAAACGTGGTAACG	tumor
CACAAACTCACCGGGT	stromal
CACAAACTCCAGTAGT	tumor
CACAAACTCTCCCTGA	stromal
CACACAACACGGACAA	stromal
CACACAACAGCTGTGC	tumor
CACACAATCAGGCCCA	tumor
CACACCTAGAGCCTAG	tumor
CACACCTAGGGTCTCC	tumor
CACACCTTCGGAGGTA	tumor
CACACCTTCTTGCAAG	tumor
CACACTCCAACGCACC	stromal
CACACTCCAATAGCAA	tumor
CACACTCCACGCCAGT	tumor
CACACTCGTCGCATCG	tumor
CACACTCGTGACGCCT	tumor
CACACTCTCTTCAACT	tumor
CACAGGCGTACTCGCG	tumor
CACAGTAAGAGTGAGA	tumor
CACAGTAAGCCAACAG	tumor
CACAGTAAGGATTCGG	tumor
CACAGTACAAGGGTCA	tumor
CACAGTACAGCCACCA	tumor
CACATAGAGGAGCGTT	tumor
CACATAGCATCGACGC	stromal
CACATAGGTGCTAGCC	stromal
CACATTTAGACTTGAA	tumor
CACATTTCAGCGAACA	tumor
CACATTTGTCTTGTCC	tumor
CACATTTTCACCGTAA	tumor
CACCACTAGTAGCGGT	tumor
CACCACTGTTACGCGC	tumor
CACCACTTCCCTCTTT	tumor
CACCAGGCATACTCTT	stromal
CACCAGGGTTACCAGT	stromal
CACCAGGGTTATTCTC	tumor
CACCTTGCAGGTTTCA	tumor
CACCTTGCATGTCCTC	tumor
CACCTTGTCAGGATCT	stromal
CACTCCAAGGGAAACA	tumor
CACTCCACAAGCCATT	tumor
CACTCCATCAATCTCT	tumor
CAGAATCAGATGCCTT	tumor
CAGAATCAGTTGCAGG	tumor
CAGAATCCATCAGTCA	tumor
CAGAGAGAGCCACTAT	tumor
CAGATCATCTCTTGAT	tumor
CAGCAGCAGACTCGGA	tumor
CAGCAGCAGGGTTCCC	tumor
CAGCAGCCATTGAGCT	tumor
CAGCAGCGTACTCTCC	stromal
CAGCAGCTCCGTCATC	stromal
CAGCCGAAGCTACCGC	tumor
CAGCCGACAGGTCTCG	tumor
CAGCCGAGTCACTGGC	tumor
CAGCCGAGTGGTTTCA	tumor
CAGCCGATCTTGTACT	stromal
CAGCGACAGAGACGAA	stromal
CAGCGACCAGGGATTG	tumor
CAGCGACGTCTGATCA	stromal
CAGCGACTCGTTGACA	tumor
CAGCTAAAGAACTCGG	tumor
CAGCTAAGTCTTCTCG	stromal
CAGCTGGGTACGACCC	tumor
CAGCTGGGTGTGCGTC	stromal
CAGCTGGTCGGGAGTA	stromal
CAGGTGCAGATCCGAG	tumor
CAGGTGCGTCGAATCT	tumor
CAGGTGCGTTCTGTTT	tumor
CAGGTGCGTTGGTTTG	tumor
CAGGTGCTCGCAAACT	tumor
CAGTAACCAGATGAGC	tumor
CAGTAACGTAGTACCT	tumor
CAGTAACGTCCATGAT	tumor
CAGTAACTCGCCAAAT	stromal
CAGTAACTCTTCAACT	stromal
CAGTCCTAGGTAAACT	stromal
CAGTCCTCAGTAAGCG	tumor
CAGTCCTGTATTAGCC	tumor
CAGTCCTTCAGGATCT	tumor
CAGTCCTTCTCCTATA	tumor
CATATGGAGGCCATAG	tumor
CATATGGAGTTGCAGG	tumor
CATATGGGTACTCAAC	tumor
CATATGGGTCGATTGT	tumor
CATATGGGTTCTGGTA	tumor
CATATGGTCGAGGTAG	tumor
CATATTCAGGCACATG	tumor
CATATTCGTTATCGGT	stromal
CATATTCGTTGCGTTA	tumor
CATCAAGAGCTGATAA	stromal
CATCAGAAGAACAACT	tumor
CATCAGAAGCTCCTTC	stromal
CATCAGAGTCTGGAGA	tumor
CATCAGAGTGGTCCGT	tumor
CATCAGAGTGTGTGCC	tumor
CATCCACAGCCAGTAG	tumor
CATCCACAGCGTCAAG	tumor
CATCCACCAAGGCTCC	tumor
CATCCACCAATGAATG	stromal
CATCCACCAATTCCTT	tumor
CATCCACGTAAGCACG	tumor
CATCCACGTCCGAGTC	tumor
CATCCACTCAGTTTGG	tumor
CATCGAAGTAAATGAC	stromal
CATCGGGGTACCGTAT	tumor
CATCGGGTCATGGTCA	tumor
CATGACAAGGCGACAT	tumor
CATGACAAGGGATACC	tumor
CATGACAGTGGCAAAC	tumor
CATGACATCTTACCTA	tumor
CATGCCTCACATGACT	tumor
CATGCCTCACTGAAGG	tumor
CATGCCTGTGCGCTTG	tumor
CATGCCTTCCAACCAA	tumor
CATGGCGGTTATTCTC	tumor
CATTCGCCACATTCGA	tumor
CATTCGCGTATATGAG	stromal
CCAATCCAGACGCACA	tumor
CCAATCCAGGATGGTC	tumor
CCAATCCCACTCAGGC	tumor
CCAATCCTCAAGGCTT	tumor
CCAATCCTCCACGTTC	tumor
CCACCTAGTCCTAGCG	tumor
CCACGGAAGGATGGAA	tumor
CCACGGACAGCGTTCG	tumor
CCACGGATCAATCTCT	tumor
CCACGGATCGGTTAAC	tumor
CCACTACTCTTTCCTC	tumor
CCAGCGAAGGCCATAG	tumor
CCATGTCCAGATGGCA	stromal
CCATGTCCAGCTCGAC	tumor
CCATGTCGTAGCCTCG	stromal
CCATGTCGTAGCGTCC	tumor
CCATGTCGTATTCTCT	tumor
CCATGTCGTGTTCTTT	tumor
CCATTCGAGTCACGCC	tumor
CCATTCGCAGTTCCCT	tumor
CCATTCGCATCTCGCT	tumor
CCCAATCCAATCAGAA	tumor
CCCAATCGTATGAATG	tumor
CCCAGTTAGACTTGAA	tumor
CCCAGTTAGTCGTTTG	stromal
CCCAGTTGTAGGCATG	tumor
CCCATACGTACAGTTC	tumor
CCCATACTCACATAGC	stromal
CCCTCCTGTACTCTCC	stromal
CCCTCCTGTAGGCTGA	tumor
CCCTCCTGTCCAACTA	stromal
CCCTCCTTCCTTGACC	tumor
CCGGGATCAGATCCAT	tumor
CCGGGATCATTCGACA	stromal
CCGGTAGAGATAGTCA	tumor
CCGGTAGGTATAGGTA	tumor
CCGGTAGGTCTAGCCG	stromal
CCGTACTCACCTATCC	tumor
CCGTACTGTAGCTTGT	tumor
CCGTACTTCCTACAGA	tumor
CCGTGGATCCGTAGGC	tumor
CCGTTCAAGGCTAGGT	tumor
CCTAAAGCAGTGGAGT	tumor
CCTAAAGGTTAAAGTG	stromal
CCTACACAGAGGTAGA	tumor
CCTACACTCCCAAGAT	tumor
CCTACACTCCGCGCAA	stromal
CCTACCACACGCATCG	tumor
CCTACCATCAAACGGG	stromal
CCTAGCTCAAGTCTGT	tumor
CCTAGCTTCATTTGGG	tumor
CCTCAGTAGGCAATTA	tumor
CCTCAGTAGTCAAGCG	stromal
CCTCAGTAGTCATCCA	tumor
CCTCAGTAGTGCCAGA	stromal
CCTCAGTCATCGTCGG	stromal
CCTCAGTGTGGACGAT	stromal
CCTCAGTTCTGACCTC	tumor
CCTCTGATCATAACCG	stromal
CCTTACGAGCCACGTC	stromal
CCTTACGTCCTGTAGA	tumor
CCTTCCCAGAAGGGTA	tumor
CCTTCCCAGAATCTCC	stromal
CCTTCCCCAACACGCC	tumor
CCTTCCCTCTCGATGA	tumor
CCTTCGACAAGCGTAG	stromal
CCTTCGACATATGAGA	stromal
CCTTTCTCAAGCTGAG	tumor
CCTTTCTCAAGTACCT	tumor
CCTTTCTTCAATAAGG	tumor
CCTTTCTTCTGTCTCG	stromal
CGAACATAGGCTCATT	tumor
CGAACATGTAGCACGA	tumor
CGAACATGTCCGTGAC	tumor
CGAATGTAGCGTCTAT	tumor
CGAATGTAGGGCTCTC	tumor
CGAATGTCACAGAGGT	stromal
CGAATGTGTGAGGCTA	tumor
CGAATGTTCATCGGAT	tumor
CGACCTTAGGGTTTCT	tumor
CGACCTTAGTGGTAGC	tumor
CGACCTTGTTCCGGCA	tumor
CGACTTCAGATGTCGG	stromal
CGACTTCGTATTACCG	tumor
CGACTTCTCCTAGTGA	tumor
CGACTTCTCTACGAGT	tumor
CGAGAAGAGAGGTTGC	tumor
CGAGAAGCAGCGAACA	tumor
CGAGAAGGTGTTTGTG	stromal
CGAGAAGTCAGGATCT	stromal
CGAGAAGTCGTCGTTC	tumor
CGAGCACCAAAGGAAG	stromal
CGAGCACCAGTCGATT	tumor
CGAGCCACAGTCGATT	tumor
CGATCGGAGCCGCCTA	tumor
CGATCGGAGCGCTTAT	stromal
CGATCGGCACATCTTT	tumor
CGATCGGGTATGGTTC	tumor
CGATCGGGTCGTCTTC	tumor
CGATCGGTCACATGCA	tumor
CGATGGCAGCTAAACA	tumor
CGATGGCCAGCCACCA	tumor
CGATGGCCATGGTTGT	tumor
CGATGGCTCCGATATG	stromal
CGATGTACATTGGTAC	tumor
CGATGTATCGGTCTAA	stromal
CGATTGAAGACGCACA	tumor
CGATTGAAGTGGGATC	tumor
CGATTGAGTACATCCA	stromal
CGATTGAGTCTAGCCG	tumor
CGCCAAGGTTGATTCG	tumor
CGCCAAGTCAACCAAC	tumor
CGCCAAGTCTGGAGCC	tumor
CGCGGTACAGTGACAG	stromal
CGCGGTAGTAAATGAC	tumor
CGCGGTAGTCGTCTTC	tumor
CGCGGTATCCTCAACC	tumor
CGCGTTTAGCGTGAGT	tumor
CGCTATCAGCTAACTC	tumor
CGCTGGACATCACGAT	tumor
CGCTGGATCGTTGCCT	tumor
CGCTTCAAGGCGCTCT	stromal
CGCTTCAGTTTGGGCC	tumor
CGGACACAGCATGGCA	tumor
CGGACACGTCGCTTTC	tumor
CGGACACTCCCTCAGT	stromal
CGGACGTCAAGACACG	tumor
CGGACGTCAAGCCTAT	tumor
CGGACGTCAGACTCGC	tumor
CGGACGTGTGGCTCCA	tumor
CGGACTGAGGCGACAT	stromal
CGGACTGAGTAATCCC	tumor
CGGACTGCATGCCCGA	stromal
CGGACTGGTGACCAAG	tumor
CGGACTGTCTACTTAC	stromal
CGGAGCTTCCAGTAGT	tumor
CGGAGTCCAGATTGCT	tumor
CGGAGTCCATTGGTAC	stromal
CGGAGTCTCCTTCAAT	tumor
CGGCTAGCAAACCTAC	stromal
CGGCTAGCATGATCCA	tumor
CGGCTAGGTAACGACG	tumor
CGGCTAGGTCTAGTGT	stromal
CGGCTAGTCCGCTGTT	tumor
CGGGTCACACGTCAGC	tumor
CGGGTCATCCTAAGTG	tumor
CGGGTCATCGCTGATA	stromal
CGGTTAAAGAAACCTA	tumor
CGTAGCGCACAACTGT	tumor
CGTAGGCAGAGCTATA	stromal
CGTAGGCAGGGTGTTG	stromal
CGTAGGCTCATCATTC	stromal
CGTCAGGAGAAGGGTA	tumor
CGTCAGGTCTTGGGTA	tumor
CGTCTACCAAGTAGTA	stromal
CGTCTACCAGTCGTGC	stromal
CGTGAGCGTAAACGCG	tumor
CGTGTAACAAGTACCT	tumor
CGTGTAATCCAGAGGA	tumor
CGTTAGATCCTAGGGC	tumor
CGTTAGATCGATAGAA	tumor
CGTTCTGAGGAGTTGC	tumor
CGTTCTGGTAGCCTCG	tumor
CGTTGGGAGTGTGAAT	tumor
CGTTGGGGTAGCAAAT	tumor
CGTTGGGTCTTTAGGG	tumor
CTAACTTAGAGGGATA	tumor
CTAATGGAGGAACTGC	tumor
CTAATGGCATCGGTTA	tumor
CTAATGGGTCGCTTTC	stromal
CTACACCCATTTCAGG	stromal
CTACACCGTCTCTTAT	stromal
CTACACCTCTAAGCCA	stromal
CTACACCTCTTTACAC	tumor
CTACCCAAGGCGTACA	tumor
CTACCCAAGTGTACCT	tumor
CTACCCAAGTGTACTC	tumor
CTACCCACAAGAGTCG	tumor
CTACCCACACAACTGT	tumor
CTACCCAGTAACGCGA	tumor
CTACGTCCACCACGTG	tumor
CTAGAGTTCTCGATGA	stromal
CTAGCCTAGCTGCGAA	tumor
CTAGCCTCAATAGCGG	tumor
CTAGCCTCAGCGAACA	tumor
CTAGCCTCATCGGAAG	tumor
CTAGCCTGTCGAGTTT	tumor
CTAGCCTGTCTACCTC	tumor
CTAGTGAGTTGCGTTA	tumor
CTCACACCACGAAAGC	tumor
CTCAGAAAGAGGTACC	tumor
CTCAGAAAGATCGGGT	tumor
CTCAGAAAGTTGAGTA	tumor
CTCAGAAGTGAGGGAG	tumor
CTCATTAAGATCCCAT	stromal
CTCATTACACCTCGGA	tumor
CTCATTACATTGTGCA	tumor
CTCATTATCAGCCTAA	tumor
CTCCTAGAGGACACCA	tumor
CTCCTAGAGGCAATTA	stromal
CTCCTAGCAATCGGTT	tumor
CTCGAAAAGTACGATA	tumor
CTCGAAAAGTCTCCTC	tumor
CTCGAAAGTCACTTCC	stromal
CTCGAGGCACGTCAGC	tumor
CTCGAGGGTGATAAAC	stromal
CTCGAGGTCCAGAGGA	tumor
CTCGAGGTCCATGAAC	tumor
CTCGAGGTCTGGTGTA	tumor
CTCGGAGTCGAGAACG	stromal
CTCGGAGTCTTGTATC	tumor
CTCGGGAGTGTGTGCC	tumor
CTCGGGAGTTACGTCA	stromal
CTCGGGAGTTTGTTTC	tumor
CTCGTACGTTGAGGTG	tumor
CTCGTACTCCGCGTTT	tumor
CTCGTCAGTTCTCATT	tumor
CTCTAATCAGGACCCT	tumor
CTCTAATGTCAGCTAT	tumor
CTCTAATTCTCGATGA	tumor
CTCTACGAGTGGAGAA	stromal
CTCTACGGTCGAAAGC	tumor
CTCTACGTCATCACCC	stromal
CTCTACGTCGTTTGCC	tumor
CTCTGGTAGGCGATAC	tumor
CTGAAACAGAAGAAGC	tumor
CTGAAACAGTATTGGA	tumor
CTGAAACCACGTAAGG	stromal
CTGAAACCATGTTCCC	stromal
CTGAAACGTAGCGCTC	tumor
CTGAAACTCATACGGT	tumor
CTGAAACTCATCTGTT	tumor
CTGAAACTCATGCATG	stromal
CTGAAACTCCTTGCCA	stromal
CTGAAGTCAGGGCATA	tumor
CTGAAGTTCAGAGGTG	tumor
CTGAAGTTCTGAAAGA	tumor
CTGATAGCAGTACACT	stromal
CTGATCCAGAAACCTA	tumor
CTGATCCAGCTAAACA	tumor
CTGATCCGTCGGCTCA	tumor
CTGCCTATCAGTCCCT	stromal
CTGCGGAAGAAACCTA	tumor
CTGCGGAAGAGATGAG	stromal
CTGCTGTAGAGGTTAT	stromal
CTGCTGTAGCATGGCA	tumor
CTGCTGTCACTGTCGG	tumor
CTGCTGTCATAAAGGT	tumor
CTGCTGTTCATGTAGC	stromal
CTGCTGTTCCGCAAGC	stromal
CTGGTCTAGAATCTCC	tumor
CTGGTCTCAACTGCTA	stromal
CTGGTCTCACTGTGTA	tumor
CTGGTCTGTAAGCACG	tumor
CTGGTCTGTGTCAATC	tumor
CTGGTCTGTGTTAAGA	stromal
CTGGTCTTCCCTAACC	tumor
CTGTGCTAGGAGTACC	tumor
CTGTGCTCAGACACTT	stromal
CTGTGCTGTCGAATCT	tumor
CTGTGCTTCTCGCTTG	tumor
CTGTTTACACTTAAGC	tumor
CTGTTTACATCTATGG	tumor
CTGTTTACATGACATC	tumor
CTGTTTAGTAAGTGGC	stromal
CTTAACTAGAGGTTGC	tumor
CTTAACTCACGACGAA	tumor
CTTAACTGTTGAACTC	tumor
CTTAACTTCAGTCAGT	stromal
CTTAACTTCGGTTCGG	stromal
CTTACCGCAATGGACG	tumor
CTTACCGGTCCGAATT	tumor
CTTAGGACAATGGACG	tumor
CTTAGGACATGCATGT	tumor
CTTAGGAGTTTGACTG	tumor
CTTAGGATCGCGATCG	tumor
CTTCTCTCAATGGATA	tumor
CTTCTCTGTAATAGCA	tumor
CTTGGCTAGACTAGAT	tumor
CTTGGCTGTCATATCG	tumor
CTTGGCTTCAAAGACA	tumor
CTTGGCTTCCAAGCCG	tumor
CTTTGCGAGTCCGTAT	stromal
CTTTGCGGTCATACTG	stromal
GAAACTCAGATGTTAG	tumor
GAAACTCGTATATGAG	stromal
GAAATGACATGGGAAC	tumor
GAAATGAGTCTCGTTC	tumor
GAAATGATCAGTTGAC	stromal
GAACATCCAGTTTACG	tumor
GAACATCTCCCAAGAT	tumor
GAACCTAAGGACAGCT	stromal
GAACCTACACATGTGT	tumor
GAACCTACATCCAACA	stromal
GAACCTAGTCCGACGT	stromal
GAACCTATCTTTACAC	tumor
GAACGGAAGCGGATCA	tumor
GAACGGAAGCTTATCG	tumor
GAACGGAAGTGCGTGA	stromal
GAACGGAAGTGGGTTG	stromal
GAAGCAGAGAGCAATT	tumor
GAAGCAGCAAGAAGAG	tumor
GAAGCAGCAAGCGATG	tumor
GAAGCAGGTCACCCAG	tumor
GAAGCAGGTCTCCATC	stromal
GAAGCAGTCACGGTTA	stromal
GAATAAGGTAGCGATG	stromal
GAATAAGGTGTCGCTG	tumor
GAATGAACAGGACCCT	stromal
GACACGCCAGCAGTTT	tumor
GACACGCGTGTTCTTT	tumor
GACAGAGGTATAATGG	tumor
GACAGAGGTCGAATCT	tumor
GACCAATCACTAAGTC	stromal
GACCAATCAGTAAGAT	tumor
GACCAATCAGTGGGAT	tumor
GACCAATGTAGAGCTG	tumor
GACCAATTCTGGTGTA	tumor
GACCTGGAGGACAGAA	stromal
GACCTGGCAGTAGAGC	tumor
GACGCGTCAACTGCTA	tumor
GACGCGTCATCGATTG	stromal
GACGCGTGTCCGTCAG	tumor
GACGGCTCAATGTAAG	stromal
GACGGCTGTCCAGTTA	stromal
GACGTGCCAACACGCC	tumor
GACGTGCGTTACGACT	stromal
GACGTGCGTTATGTGC	tumor
GACGTGCTCCAGATCA	tumor
GACGTGCTCGAGCCCA	tumor
GACGTTACATAACCTG	stromal
GACGTTAGTTTGGCGC	tumor
GACGTTATCCGGCACA	tumor
GACTAACAGAATGTTG	tumor
GACTAACAGGTAGCCA	stromal
GACTAACAGTGTCCCG	tumor
GACTAACTCCTCGCAT	tumor
GACTAACTCTTGTACT	stromal
GACTACAGTTACGACT	tumor
GACTACAGTTTGACAC	tumor
GACTGCGGTGGTGTAG	tumor
GACTGCGTCAACCAAC	tumor
GACTGCGTCTACTTAC	stromal
GAGCAGAAGGATGGAA	tumor
GAGCAGAAGGGCTCTC	stromal
GAGGTGAGTTAAAGAC	tumor
GAGGTGATCGTAGATC	tumor
GAGTCCGAGGATGTAT	tumor
GAGTCCGCACATAACC	tumor
GAGTCCGCACCCTATC	stromal
GAGTCCGCACGGCCAT	tumor
GAGTCCGCATCATCCC	tumor
GAGTCCGTCCAGGGCT	tumor
GAGTCCGTCTCTAGGA	tumor
GATCAGTCAGTCGATT	tumor
GATCAGTTCAACACGT	tumor
GATCAGTTCCACGCAG	tumor
GATCAGTTCCATTCTA	tumor
GATCGATAGTATCGAA	stromal
GATCGATCAATGTAAG	tumor
GATCGATCAGGTTTCA	tumor
GATCGATCATATACCG	stromal
GATCGATTCAATAAGG	stromal
GATCGATTCCAAGCCG	tumor
GATCGCGAGAGTCGGT	tumor
GATCGCGAGCTACCTA	tumor
GATCGCGCAGCCTTTC	tumor
GATCGCGGTCCATCCT	tumor
GATCGCGTCAGATAAG	tumor
GATCGCGTCATCATTC	stromal
GATCGTAAGACAAAGG	stromal
GATCTAGAGCTCAACT	tumor
GATCTAGCAGGCGATA	stromal
GATCTAGCATGGTCTA	tumor
GATCTAGGTTAAGTAG	tumor
GATCTAGTCTCCAGGG	stromal
GATGAAAAGGGAACGG	tumor
GATGAAACATCACGTA	tumor
GATGAAATCGGACAAG	tumor
GATGAGGAGGATGGAA	tumor
GATGAGGCATCGATTG	tumor
GATGAGGTCGACAGCC	tumor
GATGAGGTCTCCTATA	stromal
GATGCTACACATTAGC	tumor
GATGCTACAGCTTCGG	tumor
GATTCAGAGGTTACCT	tumor
GATTCAGCACATTAGC	stromal
GATTCAGCACTGTGTA	stromal
GATTCAGCAGCCTTTC	tumor
GATTCAGGTAATTGGA	stromal
GATTCAGTCGCTTGTC	stromal
GCAAACTAGCCGATTT	tumor
GCAAACTAGGATGGTC	tumor
GCAAACTCATTGAGCT	tumor
GCAAACTTCCCACTTG	tumor
GCAAACTTCCGGCACA	stromal
GCAATCAGTCCGAACC	stromal
GCAATCAGTCGAACAG	tumor
GCAATCATCGTGTAGT	tumor
GCACATAAGCGTTGCC	tumor
GCACATACAAGGTTCT	tumor
GCACATACACGGCGTT	tumor
GCACATAGTAAGCACG	tumor
GCACATATCGAGCCCA	tumor
GCACATATCGATCCCT	tumor
GCACTCTAGTCACGCC	tumor
GCACTCTCAGTCAGCC	tumor
GCACTCTCATGACGGA	tumor
GCACTCTGTAGGACAC	tumor
GCAGCCAAGATAGCAT	stromal
GCAGCCAAGGAGCGAG	tumor
GCAGCCAAGTCGATAA	tumor
GCAGCCACAGTCGATT	tumor
GCAGCCATCGTGACAT	stromal
GCAGTTAAGATCTGCT	stromal
GCAGTTAGTCCCTTGT	tumor
GCAGTTAGTTACAGAA	tumor
GCAGTTAGTTGCGCAC	stromal
GCAGTTATCAATCTCT	tumor
GCATACACATTTGCCC	stromal
GCATACAGTTATCCGA	tumor
GCATGATAGGGCACTA	tumor
GCATGATAGTTAGGTA	tumor
GCATGATAGTTATCGC	tumor
GCATGCGAGTGGAGTC	tumor
GCATGCGCACTAAGTC	tumor
GCATGCGGTAAGTGGC	stromal
GCATGCGTCATCTGCC	tumor
GCATGTAAGTGGACGT	tumor
GCATGTACACAAGTAA	tumor
GCATGTAGTCCGAGTC	tumor
GCATGTATCACATACG	stromal
GCCAAATTCCAAGCCG	tumor
GCCTCTAAGCGCCTCA	tumor
GCCTCTACACGGTAGA	tumor
GCCTCTAGTGCAGTAG	stromal
GCCTCTAGTTCCATGA	tumor
GCCTCTATCTAACTTC	tumor
GCGACCACACGTCTCT	stromal
GCGAGAAAGGCCCTTG	stromal
GCGAGAACAGAAGCAC	tumor
GCGAGAACAGATCTGT	tumor
GCGAGAACATACAGCT	stromal
GCGCAACGTATTCGTG	tumor
GCGCAACGTCCGTTAA	tumor
GCGCAACGTCTCTTAT	tumor
GCGCAGTTCAGTGTTG	tumor
GCGCAGTTCCGCATAA	tumor
GCGCAGTTCTGCTGTC	tumor
GCGCCAAAGCGTAGTG	stromal
GCGCCAAAGGCTATCT	tumor
GCGCCAACATCGGACC	tumor
GCGCCAAGTCTAGTGT	stromal
GCGCGATCAGTTCCCT	tumor
GCGCGATTCAACACGT	tumor
GCGCGATTCGTCACGG	tumor
GCGCGATTCTGATTCT	tumor
GCGGGTTCACCCATTC	tumor
GCGGGTTTCAGGATCT	tumor
GCGGGTTTCATGTCTT	stromal
GCGGGTTTCTTGCCGT	stromal
GCTCCTAAGAAAGTGG	tumor
GCTCCTAGTTTGGCGC	stromal
GCTCCTATCCTTTACA	tumor
GCTCTGTAGATCGGGT	stromal
GCTCTGTGTCTCTCTG	tumor
GCTCTGTTCGCCATAA	tumor
GCTGCAGCAGTCAGAG	tumor
GCTGCAGTCCGTAGGC	tumor
GCTGCGAAGCCCTAAT	stromal
GCTGCGATCACCTCGT	tumor
GCTGCTTCACACAGAG	tumor
GCTGCTTCAGACTCGC	tumor
GCTGCTTTCCTATTCA	tumor
GCTGCTTTCTCCCTGA	tumor
GCTGGGTAGTGAACAT	stromal
GCTGGGTCACCGAAAG	tumor
GCTGGGTTCGGAAATA	tumor
GCTTCCACATGGAATA	tumor
GCTTCCAGTCTCACCT	stromal
GCTTCCAGTTATCACG	tumor
GCTTGAAAGGCCGAAT	tumor
GCTTGAAAGGGAAACA	tumor
GCTTGAACAGCCTTTC	tumor
GCTTGAACAGCGTTCG	tumor
GCTTGAACATATGAGA	stromal
GCTTGAAGTCTAGTCA	stromal
GGAAAGCAGGTGATAT	stromal
GGAAAGCCAGCTGTAT	stromal
GGAAAGCGTGAGGGTT	tumor
GGAACTTGTACTCTCC	tumor
GGAACTTGTAGAGTGC	tumor
GGAACTTTCTACCTGC	tumor
GGAATAAAGATCACGG	tumor
GGAATAACACTGCCAG	tumor
GGAATAAGTATATGGA	tumor
GGAATAATCAACCAAC	tumor
GGAATAATCAACGAAA	stromal
GGACAAGAGGACATTA	tumor
GGACAAGCAAGAAAGG	stromal
GGACAAGGTCAAACTC	tumor
GGACAAGGTGACTACT	tumor
GGACAGAAGATATGGT	stromal
GGACAGAGTCGACTAT	stromal
GGACAGAGTCTGATTG	stromal
GGACATTTCTCGCTTG	stromal
GGACGTCAGACCCACC	tumor
GGACGTCCAGTTAACC	tumor
GGACGTCCATCAGTAC	tumor
GGACGTCGTGAGGGTT	stromal
GGAGCAATCTAACGGT	tumor
GGATTACAGAAACCTA	stromal
GGATTACAGCCACGCT	tumor
GGATTACGTGTCGCTG	tumor
GGATTACGTTTAGGAA	tumor
GGCAATTCACCCTATC	tumor
GGCAATTGTCTCCACT	tumor
GGCCGATAGCGCTCCA	stromal
GGCCGATAGTGTACGG	tumor
GGCCGATGTTCAGACT	tumor
GGCCGATTCAAACCGT	stromal
GGCCGATTCCATTCTA	stromal
GGCGACTCATGAAGTA	tumor
GGCGACTGTCTCTCGT	tumor
GGCGACTGTTGGACCC	tumor
GGCGACTTCAGGCCCA	tumor
GGCGTGTCAGGATTGG	tumor
GGCGTGTGTCCAACTA	tumor
GGCGTGTTCGTTGACA	tumor
GGCTCGAGTCTGGTCG	stromal
GGCTCGAGTGTAATGA	tumor
GGCTGGTCACCTATCC	stromal
GGCTGGTCAGTCGATT	tumor
GGCTGGTGTCCGAAGA	tumor
GGCTGGTTCCCATTAT	tumor
GGCTGGTTCGCTGATA	tumor
GGGAATGAGCTTATCG	stromal
GGGAATGAGTTACGGG	tumor
GGGAATGCACGACTCG	tumor
GGGACCTCACATAACC	stromal
GGGACCTCACATGGGA	tumor
GGGACCTGTCCCGACA	stromal
GGGAGATCAATCTGCA	tumor
GGGAGATCATGCCTAA	tumor
GGGAGATTCAGTGTTG	tumor
GGGATGAAGGGTTTCT	tumor
GGGATGACATACCATG	tumor
GGGATGAGTTAAGAAC	tumor
GGGATGAGTTGTTTGG	stromal
GGGCACTCACAGGCCT	tumor
GGGCACTTCAGAGACG	tumor
GGGCATCCAACCGCCA	tumor
GGGCATCTCTCCAGGG	tumor
GGGTCTGAGCACGCCT	tumor
GGGTCTGGTGGCAAAC	tumor
GGGTCTGTCACTATTC	tumor
GGGTTGCAGAGACGAA	tumor
GGGTTGCCAGCTTCGG	tumor
GGGTTGCGTTAAGGGC	stromal
GGTATTGAGCGCTTAT	tumor
GGTATTGGTCTAGTCA	tumor
GGTATTGGTTCCGTCT	tumor
GGTATTGTCGGCCGAT	tumor
GGTGAAGGTAAAGGAG	tumor
GGTGAAGTCCAGTATG	tumor
GGTGAAGTCGAGAGCA	tumor
GGTGCGTAGCCATCGC	stromal
GGTGCGTCACACCGCA	tumor
GGTGCGTTCGGCTTGG	tumor
GGTGTTAAGTTCGCGC	tumor
GGTGTTAGTTATCCGA	tumor
GGTGTTATCGTCTGAA	tumor
GTAACGTAGATATGCA	tumor
GTAACGTCACAGGTTT	tumor
GTAACGTGTTCGTCTC	tumor
GTAACGTTCACATAGC	stromal
GTAACTGAGCAAATCA	tumor
GTAACTGTCCCATTTA	tumor
GTACGTAAGAGGACGG	tumor
GTACGTATCATTATCC	tumor
GTACGTATCCTGTAGA	tumor
GTACGTATCGTGGTCG	stromal
GTACTCCCAGCCAATT	tumor
GTACTCCGTTGATTGC	stromal
GTACTCCTCTACGAGT	stromal
GTACTCCTCTGGGCCA	tumor
GTACTTTCAGGTGCCT	tumor
GTAGGCCAGCGTGAAC	tumor
GTAGGCCCAGATGAGC	stromal
GTAGGCCGTTCCGGCA	tumor
GTAGTCATCCCAGGTG	stromal
GTAGTCATCCCGACTT	tumor
GTATCTTCAGTCTTCC	stromal
GTATCTTGTTCCATGA	tumor
GTATTCTAGATGGGTC	tumor
GTCAAGTCAAACGTGG	stromal
GTCACAACAAGTTGTC	tumor
GTCACAAGTATAAACG	tumor
GTCACGGGTTTGTTGG	tumor
GTCACGGTCGGATGGA	tumor
GTCATTTCATGTCCTC	stromal
GTCCTCAAGGACGAAA	tumor
GTCCTCAGTACCGCTG	stromal
GTCCTCATCATAAAGG	stromal
GTCGTAAAGACTGGGT	tumor
GTCGTAAGTTACGTCA	tumor
GTCGTAAGTTCGTCTC	tumor
GTCTCGTGTAAGTGGC	tumor
GTCTTCGAGCGCTTAT	tumor
GTCTTCGGTATGAAAC	tumor
GTCTTCGGTTCCACTC	stromal
GTCTTCGTCAACCAAC	tumor
GTGAAGGCAGTCTTCC	stromal
GTGCAGCAGATCGGGT	stromal
GTGCAGCAGCCAGGAT	tumor
GTGCAGCAGCGTCTAT	stromal
GTGCAGCCAATGGACG	tumor
GTGCAGCGTACTCAAC	tumor
GTGCATAGTCTCACCT	stromal
GTGCATAGTTCTGAAC	tumor
GTGCGGTAGAGACTTA	tumor
GTGCGGTTCCGTTGCT	tumor
GTGCGGTTCGTCACGG	tumor
GTGCGGTTCTCTGCTG	tumor
GTGCTTCGTGGCGAAT	tumor
GTGGGTCCAAGAAGAG	tumor
GTGGGTCCACCGAATT	stromal
GTGGGTCCACTAAGTC	tumor
GTGGGTCCACTTAAGC	tumor
GTGGGTCGTAGAGTGC	tumor
GTGGGTCGTCCGTTAA	tumor
GTGGGTCGTGCGCTTG	tumor
GTGTGCGAGGATGCGT	tumor
GTGTGCGCAGCAGTTT	tumor
GTGTGCGTCGAGGTAG	tumor
GTGTTAGAGGTAGCTG	tumor
GTGTTAGCAAAGGTGC	tumor
GTGTTAGCAGGTCTCG	tumor
GTGTTAGTCATGTCCC	stromal
GTGTTAGTCCTACAGA	stromal
GTGTTAGTCGGAAACG	tumor
GTTAAGCAGCAGATCG	tumor
GTTAAGCTCATGGTCA	stromal
GTTAAGCTCCTTAATC	tumor
GTTACAGAGGGCACTA	tumor
GTTACAGGTCTCAACA	tumor
GTTCATTAGGTACTCT	tumor
GTTCATTCAAGCCTAT	tumor
GTTCATTCACTGAAGG	tumor
GTTCATTCATATACCG	stromal
GTTCATTTCGGATGTT	tumor
GTTCATTTCTTGCATT	tumor
GTTCGGGGTCGCATAT	stromal
GTTCGGGTCAGTTGAC	tumor
GTTCGGGTCTTGAGAC	tumor
GTTCTCGAGTCCTCCT	tumor
GTTCTCGCAAGTACCT	tumor
GTTCTCGCAGGAATGC	stromal
GTTCTCGGTTGTGGAG	tumor
GTTCTCGTCACCGGGT	tumor
GTTCTCGTCAGCTCTC	tumor
GTTCTCGTCTCACATT	tumor
GTTTCTAAGAACAACT	stromal
GTTTCTATCACAGTAC	tumor
TAAACCGAGACATAAC	stromal
TAAACCGCAGCTCCGA	stromal
TAAACCGGTGCGAAAC	stromal
TAAACCGGTTACAGAA	tumor
TAAACCGGTTGCGTTA	stromal
TAAACCGTCCCTTGCA	tumor
TAAGAGAAGGCTAGGT	tumor
TAAGAGAAGTTCGATC	tumor
TAAGAGACAAAGCAAT	tumor
TAAGCGTAGCTAACAA	tumor
TAAGCGTGTCTCTTTA	tumor
TAAGCGTGTGCGATAG	stromal
TAAGCGTGTTCGTCTC	tumor
TAAGTGCAGGACTGGT	stromal
TAAGTGCGTTACTGAC	stromal
TAAGTGCTCTAAGCCA	tumor
TACACGACAGACAAGC	tumor
TACACGAGTAAGCACG	stromal
TACACGATCACTCCTG	tumor
TACACGATCCTCTAGC	stromal
TACAGTGAGACGCAAC	tumor
TACAGTGTCTGGCGAC	tumor
TACCTATTCAGAGGTG	stromal
TACCTATTCCAAACAC	tumor
TACCTATTCCAAACTG	tumor
TACCTTAAGGTCGGAT	tumor
TACCTTACACCAGTTA	tumor
TACCTTAGTCTAACGT	tumor
TACGGATAGTCCGTAT	stromal
TACGGATAGTGGGTTG	tumor
TACGGATCAGGAATCG	tumor
TACGGATGTCTGGAGA	tumor
TACGGATGTTGTCTTT	tumor
TACGGATTCTCGTTTA	tumor
TACGGGCAGACCTTTG	tumor
TACGGGCCAATAGAGT	tumor
TACGGGCGTAGAAAGG	tumor
TACGGTACAGTGAGTG	tumor
TACGGTAGTAGAAAGG	tumor
TACGGTATCAACACGT	stromal
TACTCATAGCCAGAAC	tumor
TACTCATAGCTCCTCT	tumor
TACTCATCAACACCCG	stromal
TACTCATGTCTAGTGT	tumor
TACTCATGTGACGCCT	tumor
TACTCATTCTGCGTAA	tumor
TACTCGCAGATGCCAG	tumor
TACTCGCAGTGCAAGC	tumor
TACTCGCCAGGTCGTC	tumor
TACTTACGTAAGCACG	tumor
TACTTGTGTCCGTGAC	stromal
TAGACCAAGATGTCGG	tumor
TAGACCACAACTGCGC	stromal
TAGACCACAAGTTGTC	tumor
TAGACCAGTGCTAGCC	stromal
TAGACCAGTGGTACAG	stromal
TAGAGCTCACGACGAA	tumor
TAGAGCTCATTGTGCA	tumor
TAGAGCTTCATCGATG	tumor
TAGCCGGCATATGCTG	tumor
TAGCCGGGTCTCCACT	tumor
TAGCCGGTCAACACTG	tumor
TAGCCGGTCTTAGCCC	stromal
TAGGCATAGACTGGGT	stromal
TAGTGGTAGATAGGAG	tumor
TAGTGGTAGTAGCGGT	tumor
TAGTGGTCAGCGTCCA	tumor
TAGTGGTGTCAATGTC	tumor
TAGTGGTGTTAGAACA	tumor
TAGTGGTTCGCCCTTA	tumor
TAGTTGGCAAGGCTCC	stromal
TAGTTGGCAATGACCT	stromal
TAGTTGGTCTGGCGTG	tumor
TATCAGGAGAAGGGTA	stromal
TATCAGGCATCACAAC	tumor
TATCTCAAGAAACCAT	tumor
TATCTCAGTAGTAGTA	tumor
TATCTCAGTCTGATTG	tumor
TATCTCAGTTCAGACT	tumor
TATCTCATCCATGCTC	stromal
TATCTCATCCGCAGTG	tumor
TATGCCCGTAAGGATT	stromal
TATGCCCGTACAGTTC	tumor
TATTACCAGAAGATTC	tumor
TATTACCCACCAGATT	stromal
TATTACCCATATACGC	tumor
TATTACCTCAGAAATG	stromal
TATTACCTCTGTCTCG	stromal
TATTACCTCTTGCCGT	tumor
TCAACGAAGACATAAC	tumor
TCAACGAAGCGATCCC	tumor
TCAACGATCCCTAACC	tumor
TCAACGATCGGTTCGG	stromal
TCAATCTAGCCCAGCT	tumor
TCAATCTAGTGAACAT	tumor
TCAATCTCAAGTCTGT	tumor
TCAATCTTCGCGATCG	tumor
TCACAAGAGTGCCATT	tumor
TCACAAGCAGGGTACA	tumor
TCACAAGCATGCCTAA	tumor
TCACAAGGTGGTGTAG	tumor
TCACGAAAGCTGAACG	tumor
TCACGAAGTGCAACTT	tumor
TCAGATGAGTTCGATC	tumor
TCAGATGGTCTAGGTT	tumor
TCAGCAAAGCTCCCAG	tumor
TCAGCTCAGCTGCAAG	tumor
TCAGCTCCATATGGTC	stromal
TCAGCTCGTACATCCA	tumor
TCAGCTCGTCCGCTGA	tumor
TCAGCTCGTGTGACGA	tumor
TCAGGATCAAGCGTAG	tumor
TCAGGATGTAGGGACT	tumor
TCAGGATGTTAGATGA	tumor
TCAGGATTCTTGCAAG	tumor
TCAGGTAAGACTAAGT	tumor
TCAGGTAGTCTGATTG	stromal
TCAGGTATCCTTCAAT	tumor
TCATTTGGTTATGCGT	stromal
TCATTTGTCCGGCACA	tumor
TCCACACCACTTACGA	tumor
TCCACACGTACCGGCT	stromal
TCCCGATCAAGCTGTT	tumor
TCCCGATTCCGAAGAG	stromal
TCCCGATTCGTTGCCT	tumor
TCGAGGCAGTAGATGT	stromal
TCGAGGCCAATGGTCT	stromal
TCGAGGCGTGTCGCTG	tumor
TCGAGGCTCAGTTGAC	tumor
TCGCGAGCAATGGACG	tumor
TCGCGAGCAGGGTATG	tumor
TCGCGAGCAGTCGATT	tumor
TCGCGTTGTAAGAGGA	stromal
TCGCGTTGTGTTTGTG	tumor
TCGGGACTCTTCCTTC	tumor
TCGGTAAAGGATGCGT	tumor
TCGGTAAGTTGGAGGT	tumor
TCGGTAATCCCTTGCA	tumor
TCGTACCAGATGGCGT	stromal
TCGTACCAGGGATACC	tumor
TCGTACCGTAGGCATG	tumor
TCTATTGAGAAACGAG	stromal
TCTATTGCACACATGT	tumor
TCTATTGGTCTTGTCC	tumor
TCTCATAAGACACGAC	stromal
TCTCATAGTCTAGCCG	tumor
TCTCATAGTTATCACG	stromal
TCTCATAGTTTAGGAA	stromal
TCTCTAAGTCTCGTTC	tumor
TCTCTAATCACCGGGT	stromal
TCTGAGAAGGGAAACA	tumor
TCTGAGAGTCGAGATG	tumor
TCTGAGATCTCGGACG	tumor
TCTGGAAGTGTGACCC	tumor
TCTGGAATCAAACCGT	tumor
TCTGGAATCTATCCTA	tumor
TCTTCGGTCACTCTTA	tumor
TCTTCGGTCGAACGGA	tumor
TCTTCGGTCGTCACGG	tumor
TCTTTCCCATGATCCA	tumor
TCTTTCCGTGTAACGG	tumor
TCTTTCCTCTCCCTGA	stromal
TGAAAGAAGACCCACC	tumor
TGAAAGAGTATAGGGC	tumor
TGACAACAGCAACGGT	tumor
TGACGGCAGTGAAGAG	tumor
TGACGGCTCGTACGGC	stromal
TGACTAGTCTCTGAGA	tumor
TGACTTTCACCAGCAC	tumor
TGACTTTTCATAAAGG	tumor
TGACTTTTCTATCCCG	tumor
TGAGAGGAGCCGGTAA	tumor
TGAGAGGAGCGTAATA	stromal
TGAGAGGGTGAAATCA	tumor
TGAGAGGTCAGCTCTC	tumor
TGAGAGGTCTGCAAGT	tumor
TGAGCATAGCTGTCTA	tumor
TGAGCCGGTGTGCCTG	tumor
TGAGCCGTCAGAAATG	tumor
TGATTTCCACGAAATA	stromal
TGCACCTAGACTCGGA	tumor
TGCACCTAGCCTCGTG	stromal
TGCACCTCATCACAAC	tumor
TGCCAAAAGCAGGCTA	stromal
TGCCAAACAAGAAAGG	stromal
TGCCAAAGTAAGAGAG	tumor
TGCCCATCACAGGTTT	tumor
TGCCCATCAGTCTTCC	tumor
TGCCCATTCCATGAAC	tumor
TGCCCATTCGCGATCG	stromal
TGCCCATTCTCAAACG	tumor
TGCCCATTCTTGGGTA	tumor
TGCCCTAGTAAATGAC	tumor
TGCCCTAGTAGGCATG	tumor
TGCCCTATCGGAAATA	tumor
TGCGCAGGTACTCGCG	tumor
TGCGCAGTCTTACCTA	tumor
TGCGGGTGTAGCGTAG	tumor
TGCGGGTTCACATACG	tumor
TGCGGGTTCCATGAGT	tumor
TGCGTGGAGTACGACG	tumor
TGCGTGGCAGTGAGTG	tumor
TGCGTGGTCCAAACTG	stromal
TGCTACCCACCGCTAG	tumor
TGCTACCCATGAACCT	stromal
TGCTACCCATGCCCGA	tumor
TGCTACCCATGGGAAC	tumor
TGCTACCTCTTGCAAG	tumor
TGCTGCTAGGAGCGTT	tumor
TGCTGCTCAATAAGCA	tumor
TGCTGCTCACTTAAGC	tumor
TGGACGCAGTCTCAAC	stromal
TGGCCAGAGACCTAGG	tumor
TGGCCAGAGGCATGTG	stromal
TGGCCAGCAAAGTGCG	tumor
TGGCCAGCAATGGAAT	tumor
TGGCCAGCAGGACCCT	stromal
TGGCCAGCATCTCGCT	tumor
TGGCCAGCATGATCCA	stromal
TGGCCAGTCTGAGGGA	tumor
TGGCGCACAGGGCATA	tumor
TGGCTGGAGTACATGA	tumor
TGGCTGGGTAACGTTC	stromal
TGGCTGGGTTATGCGT	tumor
TGGGAAGCAAGTCTAC	tumor
TGGGAAGCAGCGATCC	tumor
TGGGAAGGTGTCAATC	stromal
TGGGCGTAGGAATCGC	tumor
TGGGCGTCACACGCTG	stromal
TGGGCGTCACGACTCG	stromal
TGGGCGTCAGACGTAG	tumor
TGGTTAGCACACATGT	stromal
TGGTTCCAGAATTCCC	tumor
TGGTTCCCACCGAATT	stromal
TGTATTCAGCTCAACT	tumor
TGTATTCAGGCGCTCT	tumor
TGTATTCGTCTCTCTG	stromal
TGTCCCAAGAGCTATA	tumor
TGTCCCACACTAGTAC	tumor
TGTGGTAAGGAGTACC	tumor
TGTGGTACAGTCTTCC	tumor
TGTGGTAGTCACACGC	stromal
TGTGGTAGTCATCCCT	stromal
TGTGGTATCACGACTA	tumor
TGTTCCGAGCGTCAAG	tumor
TGTTCCGAGGTAGCTG	stromal
TGTTCCGGTGACGCCT	tumor
TGTTCCGTCGCAAACT	tumor
TTAACTCCAAGTAATG	tumor
TTAACTCTCCTATGTT	tumor
TTAGGACCAGGCTCAC	tumor
TTAGGACCAGGTTTCA	tumor
TTAGGACGTATCGCAT	tumor
TTAGGACGTGCAGACA	stromal
TTAGGACGTGTTAAGA	tumor
TTAGGACTCTTGAGAC	tumor
TTAGGCATCTACCAGA	tumor
TTAGTTCAGACTGGGT	tumor
TTAGTTCTCGTTACGA	tumor
TTATGCTCAGCGAACA	tumor
TTATGCTGTCCAGTTA	tumor
TTATGCTGTGTTGGGA	tumor
TTATGCTTCGTTGCCT	stromal
TTCCCAGCACCTATCC	tumor
TTCCCAGGTCCGAATT	tumor
TTCCCAGTCCGTTGTC	stromal
TTCCCAGTCGCCCTTA	tumor
TTCCCAGTCGGAGGTA	tumor
TTCGAAGCAAAGGAAG	stromal
TTCGAAGCATCATCCC	tumor
TTCGAAGGTACCTACA	tumor
TTCGAAGGTTACAGAA	tumor
TTCGAAGTCGTTGCCT	tumor
TTCGGTCCACACGCTG	tumor
TTCGGTCCATAAAGGT	tumor
TTCGGTCGTAGCACGA	tumor
TTCTACAAGACTTGAA	tumor
TTCTACAAGCTGCAAG	tumor
TTCTACACATAACCTG	tumor
TTCTACAGTACTCGCG	tumor
TTCTACAGTCTCCACT	tumor
TTCTACATCCTCAACC	tumor
TTCTCAAAGAGCTGCA	tumor
TTCTCAACAAGACGTG	tumor
TTCTCAAGTTTGTTTC	stromal
TTCTCCTTCTGCGACG	tumor
TTCTTAGAGCGCCTCA	stromal
TTCTTAGTCCGGCACA	tumor
TTGAACGAGAAGGTTT	tumor
TTGAACGAGCGTGAAC	tumor
TTGACTTAGCTAACTC	tumor
TTGCCGTAGCCAGTAG	tumor
TTGCCGTAGGGTATCG	stromal
TTGCCGTCATGCCTTC	tumor
TTGCCGTTCGAGAACG	tumor
TTGCCGTTCTTGCATT	tumor
TTGCGTCAGATGTTAG	tumor
TTGCGTCAGTCCATAC	tumor
TTGCGTCGTGATGTGG	tumor
TTGCGTCTCTACGAGT	tumor
TTGGAACAGTGAACAT	tumor
TTGGAACGTTGTGGCC	tumor
TTGGCAACAATACGCT	tumor
TTGGCAAGTCCGAACC	stromal
TTGGCAAGTCTGCAAT	stromal
TTGGCAAGTTCGCGAC	tumor
TTGGCAATCGAATCCA	tumor
TTGGCAATCTAGAGTC	tumor
TTGTAGGAGTCAAGGC	tumor
TTGTAGGCAAGTCTAC	tumor
TTGTAGGCACATGTGT	tumor
TTGTAGGGTTCTGAAC	tumor
TTGTAGGTCAGCAACT	tumor
TTGTAGGTCCCAACGG	tumor
TTTACTGAGTGCTGCC	tumor
TTTACTGGTTCGTGAT	tumor
TTTATGCCACTGTTAG	stromal
TTTATGCCATGCAATC	tumor
TTTATGCGTCCTCCAT	tumor
TTTATGCTCATCGGAT	tumor
TTTCCTCAGTCGTTTG	tumor
TTTCCTCTCTCATTCA	stromal
TTTGCGCAGAATCTCC	stromal
TTTGCGCAGAGTAATC	stromal
TTTGCGCCACTACAGT	tumor
TTTGCGCGTCTCTTAT	stromal
TTTGGTTAGATATGCA	stromal
TTTGGTTCACGTAAGG	tumor
TTTGGTTGTGCATCTA	tumor
TTTGGTTTCCGCGTTT	tumor
TTTGGTTTCTTGCCGT	tumor
TTTGTCAAGAAACCAT	tumor
TTTGTCAGTAGAGTGC	stromal
TTTGTCATCTCCAGGG	tumor
